STAR_AlignmentWN1	WN1	WT_untreated
STAR_AlignmentWN2	WN2	WT_untreated
STAR_AlignmentWN3	WN3	WT_untreated
STAR_AlignmentBN1	BN1	phyB_untreated
STAR_AlignmentBN2	BN2	phyB_untreated
STAR_AlignmentBN3	BN3	phyB_untreated
STAR_AlignmentDN1	DN1	rbohD_untreated
STAR_AlignmentDN2	DN2	rbohD_untreated
STAR_AlignmentDN3	DN3	rbohD_untreated
STAR_AlignmentFN1	FN1	rbohF_untreated
STAR_AlignmentFN2	FN2	rbohF_untreated
STAR_AlignmentFN3	FN3	rbohF_untreated
STAR_AlignmentWR1	WR1	WT_red
STAR_AlignmentWR2	WR2	WT_red
STAR_AlignmentWR3	WR3	WT_red
STAR_AlignmentBR1	BR1	phyB_red
STAR_AlignmentBR2	BR2	phyB_red
STAR_AlignmentBR3	BR3	phyB_red
STAR_AlignmentDR1	DR1	rbohD_red
STAR_AlignmentDR2	DR2	rbohD_red
STAR_AlignmentDR3	DR3	rbohD_red
STAR_AlignmentFR1	FR1	rbohF_red
STAR_AlignmentFR2	FR2	rbohF_red
STAR_AlignmentFR3	FR3	rbohF_red
STAR_AlignmentWW1	WW1	WT_white
STAR_AlignmentWW2	WW2	WT_white
STAR_AlignmentWW3	WW3	WT_white
STAR_AlignmentBW1	BW1	phyB_white
STAR_AlignmentBW2	BW2	phyB_white
STAR_AlignmentBW3	BW3	phyB_white
STAR_AlignmentDW1	DW1	rbohD_white
STAR_AlignmentDW2	DW2	rbohD_white
STAR_AlignmentDW3	DW3	rbohD_white
STAR_AlignmentFW1	FW1	rbohF_white
STAR_AlignmentFW2	FW2	rbohF_white
STAR_AlignmentFW3	FW3	rbohF_white
